%s An update is available=%s: Uma atualização está disponível
Alert Message=
anonymous=anônimo(a)
Author=Autor
Check For Updates=Verificar se há Atualizações
Checking connectivity=
checking=
Click here to install version %s=Clicar aqui para instalar a versão %s
Delete Plugin=
DOWNGRADE TO VERSION=DOWNGRADE PARA A VERSÃO
Enter URL of remote plugin file or local plugin file=Digitar o URL do ficheiro remoto do plugin ou o ficheiro local do plugin
ERROR=Erro
Install Plugin=Instalar plugin
Install=Instalar
install=instalar
Installed Plugins=Plugin(s) instalado(s)
Installing Update=Instalando atualização
need check=precisa ser verificado
Next=Próximo
No plugins installed=
No release notes available=Não há notas de versão disponíveis
No response, aborting=
Plugin File Install Errors=
Plugin File=Ficheiro do Plugin
Plugin History=
Plugin Update Check=Procurar por atualização do plugin
Plugin=Plugin
Release Notes=Notas de Versão
Remove Plugin=
Remove Selected Plugins=
remove=remover
Select local plugin file=Selecionar ficheiro de plugin local
Stable=Estável
STALE=OBSOLETO
Support Thread=Tópico de suporte no fórum
Uninstall=Desinstalar
Update All Plugins=Atualizar todos os plugins
Update Incompatible=
Update Plugin=
Upgrade=Upgrade
View Release Notes=Ver Notas de Versão

; Note: April 11, 2023 - 12 missing translations
